Name,Volume,Ask Size,Ask Price,Bid Size,Bid Price,Last Price,Shares Matched,Shares Routed
UVXY,1818579,500,24.88,600,24.87,24.87,1775417,43162
VXX,1578864,635,28.08,1100,28.07,28.07,1554283,24581
IEFA,369246,4800,73.81,4600,73.80,73.80,327569,41677
VIXY,357189,31,22.96,1300,22.95,22.96,352533,4656
JPST,351547,28048,50.70,194508,50.69,50.70,351537,10
ARKG,264841,100,73.45,100,73.44,73.44,264060,781
EZU,243155,7300,47.96,4700,47.95,47.95,242754,401
USMV,196670,500,73.02,2300,73.01,73.02,193541,3129
EFV,187815,3600,50.59,2700,50.58,50.63,143293,44522
ITB,148696,800,65.82,400,65.80,65.78,145779,2917
SVXY,148137,400,54.13,208,54.11,54.12,143892,4245
RSX,140753,2500,30.28,6650,30.27,30.27,137100,3653
MTUM,140679,375,174.26,375,174.23,174.21,139829,850
INDA,134234,2000,48.82,900,48.81,48.82,133931,303
IGV,118846,25,398.26,1,398.10,398.06,113142,5704
QUAL,113920,500,131.02,500,130.99,130.97,94917,19003
PAVE,96154,600,25.32,4019,25.31,25.33,94861,1293
FLOT,83325,2522,50.81,10479,50.80,50.80,35025,48300
GOVT,59022,170450,26.56,156600,26.55,26.56,58971,51
ICSH,48114,18872,50.49,17051,50.48,50.49,48014,100
VLUE,45486,1600,100.18,400,100.16,100.15,45368,118
USHY,42258,6100,41.31,2500,41.30,41.30,42168,90
FGRO,38093,1000,20.67,1000,20.66,20.67,38093,0
ECH,35609,200,26.18,100,26.17,26.17,35309,300
ARKQ,31640,200,77.09,200,77.03,77.08,31638,2
NOBL,29277,1100,88.00,500,87.96,87.95,28877,400
POCT,28909,3400,29.28,500,29.22,29.25,28909,0
ARKX,28448,3700,19.45,576,19.44,19.45,27834,614
RYLD,26071,1300,24.82,1460,24.80,24.82,26071,0
HYD,25421,400,62.42,939,62.41,62.42,25031,390
REM,24070,300,36.17,900,36.16,36.16,24070,0
EFAV,22076,600,74.96,600,74.93,75.00,22076,0
CNYA,22037,200,41.92,1000,41.87,41.93,18418,3619
BBJP,20546,3100,58.01,1000,57.95,57.99,19571,975
IGE,20379,5100,29.40,200,29.39,29.39,20378,1
EFG,20077,600,105.97,800,105.90,105.93,19877,200
TAIL,19055,2,18.84,1400,18.80,18.81,19055,0
IDV,18492,1305,30.32,901,30.31,30.34,17791,701
PBUS,18170,1500,43.73,300,43.62,43.68,18170,0
FBCG,16394,200,32.29,100,32.24,32.27,16394,0
ESGV,15390,400,79.66,507,79.60,79.65,15390,0
VNM,14959,200,19.10,100,19.07,19.08,14476,483
BOCT,14873,3400,32.58,1000,32.53,32.54,14873,0
BBEU,13166,800,56.93,1100,56.90,56.97,12666,500
MOAT,13076,300,73.25,800,73.23,73.32,12875,201
ITA,12963,500,104.40,1300,104.30,104.31,12963,0
PICK,12698,400,40.65,300,40.53,40.66,11357,1341
CALF,12509,1200,42.22,700,42.17,42.25,12509,0
NEAR,11928,10367,50.11,17092,50.10,50.10,11928,0
BUFR,11766,2900,22.95,200,22.90,23.04,11766,0
IEO,11381,1300,58.60,1300,58.54,58.84,11381,0
SLVP,10803,400,12.26,1500,12.23,12.24,10803,0
ICVT,10359,600,99.68,600,99.61,99.64,10359,0
VUSB,10294,2499,50.13,2907,50.12,50.12,8894,1400
BBAX,9741,1000,54.03,1000,53.99,54.07,9541,200
ITM,9515,300,51.19,2300,51.18,51.18,8915,600
IQDG,9455,100,37.94,2000,37.93,37.98,8455,1000
KJAN,9128,1000,31.12,200,30.92,31.10,9128,0
IFRA,8954,300,34.07,500,34.02,34.08,8954,0
BBUS,8757,2600,78.43,300,78.39,78.45,8757,0
BALT,7412,300,25.73,400,25.69,25.70,7412,0
IYLD,7368,18700,24.00,1000,23.97,23.99,7368,0
HEFA,7212,2000,34.12,1400,34.11,34.12,7005,207
SMIN,7004,392,60.81,700,60.56,60.77,7004,0
IAGG,6824,1000,55.13,1000,55.12,55.12,6650,174
COWZ,6649,2500,43.52,2700,43.49,43.50,6649,0
BBCA,6581,1000,62.65,1000,62.62,62.79,6581,0
XDOC,6548,3500,23.99,3500,23.90,24.02,6548,0
CBOE,5842,107,123.31,7,123.15,123.19,5842,0
DRSK,5686,3000,28.98,700,28.94,29.05,5686,0
BUFD,5606,200,20.77,5000,20.68,20.75,5606,0
PRNT,5537,1000,35.35,4,35.23,35.27,5537,0
GTIP,5486,2600,57.74,800,57.71,57.73,5114,372
SMMV,5451,500,36.90,700,36.82,37.01,5451,0
QTOC,5351,200,24.24,425,24.21,24.21,5351,0
IGHG,5189,400,75.61,400,75.38,75.51,5189,0
BBIN,5187,9000,58.55,900,58.51,58.50,5099,88
USEP,5014,300,27.73,1000,27.70,27.75,5014,0
IYZ,5003,3300,32.40,600,32.38,32.41,3903,1100
NULV,4591,600,37.37,700,37.34,37.45,4591,0
FLBL,4510,1300,25.07,600,25.02,25.15,4510,0
EEMV,4351,300,62.38,300,62.31,62.36,4351,0
ACWV,4313,1200,102.16,1000,102.11,102.17,4313,0
XBOC,4273,3500,24.01,1000,23.98,24.03,4273,0
PSEP,4100,300,28.98,100,28.96,28.98,4100,0
DINT,3912,900,19.51,500,19.43,19.47,3912,0
NULG,3789,400,65.20,100,65.13,65.41,3789,0
EMHY,3771,847,44.12,800,44.10,44.12,3749,22
TSOC,3525,300,30.36,300,30.22,30.61,3525,0
FDG,3506,1000,81.54,6900,81.39,81.58,3506,0
IYJ,3486,200,106.99,600,106.92,107.17,3286,200
JEMA,3485,1000,46.83,100,46.67,47.19,3485,0
PTNQ,3337,700,55.45,700,55.41,55.50,3287,50
FBCV,3151,200,27.78,65,27.74,27.75,3151,0
VSGX,3067,1000,61.33,811,61.25,61.31,3067,0
TMFC,3057,1200,39.63,100,39.56,39.63,3057,0
LUXE,2886,1394,29.31,1,29.22,29.23,2886,0
UOCT,2858,3400,27.82,3000,27.72,27.84,2858,0
OGIG,2856,900,52.60,400,52.49,52.40,2856,0
FLQL,2844,100,41.89,1600,41.84,41.90,2844,0
XVV,2696,1500,32.93,1,32.90,32.94,2696,0
ICF,2658,1000,65.43,1001,65.38,65.45,2658,0
SMDV,2651,500,61.69,700,61.63,61.60,2651,0
XTOC,2534,200,24.05,425,24.03,24.05,2534,0
CEMB,2479,200,51.81,700,51.80,51.86,2479,0
IEIH,2382,400,34.27,400,34.21,34.20,2382,0
SYLD,2381,300,59.93,300,59.84,60.00,2381,0
OMFL,2364,600,46.12,800,46.08,46.21,2364,0
IETC,2332,500,55.55,200,55.50,55.49,2332,0
EGIS,2257,1200,32.73,1200,32.70,32.77,2257,0
AFIF,2202,2100,9.67,2200,9.65,9.66,2202,0
TOKE,1995,409,13.74,49,13.69,13.74,1995,0
NUSC,1964,400,43.34,300,43.26,43.69,1964,0
MOTI,1933,800,33.44,700,33.32,33.52,1901,32
CEFS,1908,300,21.35,100,21.21,21.38,1908,0
EOPS,1900,1600,26.57,1600,26.48,26.59,1900,0
XMPT,1896,300,29.16,170,29.08,29.17,1896,0
OCTZ,1866,1000,30.23,1000,30.10,30.26,1866,0
PAWZ,1851,700,77.45,400,77.35,77.34,1851,0
TSJA,1780,300,28.62,300,28.53,28.81,1780,0
PSMB,1749,400,16.49,400,16.39,16.44,1749,0
IYT,1703,261,243.83,48,243.63,243.70,1703,0
IEHS,1641,300,41.41,300,41.36,41.40,1641,0
IEDI,1629,300,43.79,1,43.77,43.88,1629,0
KWT,1602,100,34.06,100,33.87,34.14,502,1100
DSEP,1601,5400,32.02,5000,31.89,31.95,1601,0
EMGF,1566,600,51.26,600,51.17,51.40,530,1036
OUSA,1558,400,41.42,800,41.40,41.44,1558,0
IVRA,1545,1000,14.11,1000,14.02,14.15,1545,0
FJAN,1517,300,32.99,500,32.91,33.09,1517,0
DFNL,1497,1400,30.42,300,30.38,30.53,1497,0
PTLC,1494,300,37.60,1700,37.58,37.63,1494,0
EDEN,1486,1300,106.57,2,106.56,106.55,1486,0
FPRO,1481,1000,23.72,1000,23.71,23.72,1481,0
DIVB,1478,600,39.10,302,39.07,39.10,1477,1
IBML,1477,768,26.02,100,26.00,26.01,1477,0
FSEP,1444,400,33.85,2500,33.75,33.93,1444,0
RSXJ,1409,200,38.43,200,36.68,37.45,1309,100
JCPB,1407,600,54.55,605,54.41,54.42,1407,0
KOCT,1370,441,26.95,93,26.89,26.94,1370,0
FCTR,1356,1100,33.67,1800,33.60,33.68,1356,0
ESML,1348,200,38.89,50,38.83,39.14,1348,0
OILK,1296,1200,58.95,300,58.90,59.09,1296,0
XDSQ,1291,4500,26.99,3500,26.86,26.99,1291,0
FAIL,1251,500,23.44,500,23.09,23.19,1251,0
JMUB,1250,700,54.88,700,54.86,54.87,1250,0
MEAR,1240,260,50.16,650,50.12,50.14,1240,0
GVI,1234,200,115.33,100,115.17,115.20,1234,0
QVAL,1231,300,33.86,700,33.81,33.90,1231,0
NUEM,1223,1200,33.68,300,33.56,33.72,1223,0
KNG,1213,500,51.50,1000,51.40,51.69,1213,0
AVDR,1200,1800,29.13,100,29.07,29.27,1200,0
PSMG,1167,800,18.08,400,18.01,18.05,1167,0
IZRL,1142,518,29.03,839,29.00,29.02,1142,0
GVAL,1135,900,23.48,100,23.42,23.39,1135,0
VFMV,1114,500,97.10,500,96.99,97.45,1114,0
VOTE,1113,1000,50.73,1000,50.70,50.75,987,126
IBHG,1050,2050,24.89,2000,24.83,24.88,0,1050
REGL,1035,500,67.49,100,67.43,67.61,1035,0
HEEM,1021,1000,30.19,1000,30.12,30.23,1021,0
SHYD,1003,200,25.09,99,25.05,25.13,1003,0
KJUL,1000,400,26.07,200,26.00,26.19,1000,0
BUFF,980,500,34.87,400,34.80,35.01,980,0
BJUL,962,1800,31.49,500,31.41,31.54,962,0
DWLD,952,1663,29.55,300,29.49,29.55,952,0
EPRF,948,800,24.12,400,24.07,24.11,948,0
IGRO,942,500,65.04,36,64.75,65.00,942,0
DJAN,940,300,31.66,300,31.58,31.58,940,0
NOCT,937,400,38.84,500,38.66,38.85,937,0
IBHC,904,242,24.58,100,24.55,24.57,904,0
TYA,900,600,25.38,900,25.34,25.31,600,300
GSEW,877,300,66.57,200,66.54,66.65,877,0
HYHG,848,100,63.13,500,62.41,62.72,848,0
DBOC,797,200,28.79,200,28.68,28.86,797,0
GAA,792,300,30.94,300,30.68,30.85,792,0
NURE,790,500,35.32,100,35.28,35.43,790,0
FSMO,755,1000,22.89,1000,22.86,23.13,755,0
FRDM,730,1400,32.89,100,32.66,32.84,606,124
HELX,720,1600,50.27,1200,50.12,50.01,720,0
IBHB,701,302,24.18,100,24.16,24.20,701,0
NOVZ,700,1000,30.78,1000,30.66,31.01,700,0
DFND,696,1999,37.82,1416,37.70,37.66,696,0
FCPI,694,1300,30.36,6,30.34,30.49,694,0
SMB,685,400,18.00,3500,17.97,18.02,685,0
BBRE,657,200,96.32,200,96.24,96.82,657,0
HYIN,625,500,24.94,1,24.93,24.98,625,0
MAGA,600,400,36.15,300,36.08,36.35,600,0
VFMO,588,500,127.56,734,127.50,127.67,588,0
SHAG,582,600,51.08,700,51.06,51.06,582,0
QLC,541,600,47.11,300,47.03,47.45,541,0
EWUS,535,1300,46.75,2000,46.63,46.68,535,0
IECS,534,400,31.72,400,31.70,31.75,534,0
DFEB,527,5186,34.37,5200,34.22,34.25,527,0
PJUL,523,300,29.66,300,29.57,29.68,523,0
BBSA,520,700,51.63,1000,51.61,51.59,520,0
AESR,512,400,13.58,1400,13.54,13.64,512,0
CSM,512,500,99.82,500,99.70,99.82,512,0
VFVA,490,500,98.69,450,98.57,98.90,490,0
VIXM,487,800,32.23,100,32.17,32.14,487,0
MSTB,450,500,30.28,500,30.13,30.26,450,0
JPHY,439,600,51.83,200,51.81,51.84,439,0
SVAL,438,1000,30.09,1600,30.02,30.15,438,0
FMAG,434,1000,22.59,1000,22.56,22.57,434,0
PMAR,427,1000,30.69,800,30.61,30.64,427,0
FIBR,426,500,100.32,600,100.29,100.27,426,0
FLQM,422,2600,43.48,100,43.40,44.05,422,0
EFAD,409,700,45.96,500,45.81,45.94,409,0
PTEU,401,300,24.32,300,24.22,24.30,401,0
CBTG,400,300,25.04,1,24.98,25.19,400,0
FNOV,400,500,38.11,2700,37.97,38.14,400,0
NJAN,400,2000,41.13,200,40.93,41.00,400,0
NJUL,400,400,46.25,200,46.01,46.25,400,0
ROMO,398,100,27.67,100,27.60,27.66,398,0
BUYZ,396,1000,49.02,1200,48.93,48.90,296,100
GLDB,360,2000,23.77,1000,23.58,23.81,360,0
EYLD,357,400,35.35,100,35.08,35.48,357,0
EAOA,338,300,32.92,300,32.88,33.00,338,0
RESD,336,1000,30.28,1000,30.24,30.28,336,0
FLV,330,1000,59.09,1000,59.00,59.19,330,0
FMIL,330,100,28.51,40,28.45,28.67,330,0
HYMU,327,1300,26.38,1300,26.34,26.34,327,0
MLN,318,622,21.51,600,21.48,21.50,318,0
NUMG,310,300,53.78,300,53.66,53.71,310,0
VCEB,301,700,73.99,600,73.97,73.94,301,0
KNGS,300,3100,26.53,1000,26.32,26.64,300,0
DUSA,298,700,33.85,700,33.75,34.01,298,0
HEGD,275,1700,18.27,1400,18.16,18.37,275,0
PTMC,273,400,35.06,300,35.02,35.09,273,0
IMOM,268,300,34.02,300,33.90,34.03,268,0
VFQY,261,1000,115.89,1100,115.79,115.91,261,0
DDWM,254,1000,29.76,1000,29.69,29.81,54,200
VFLQ,245,600,109.37,1300,109.24,110.04,245,0
FDEV,232,23,28.53,40,28.50,28.60,232,0
XDQQ,221,3500,28.13,3500,28.00,28.13,221,0
XJH,218,1700,36.02,207,36.00,36.08,218,0
ENOR,216,400,29.37,700,29.26,29.42,216,0
IEFN,206,400,31.76,400,31.72,31.81,206,0
DURA,205,200,30.34,300,30.32,30.50,205,0
EWGS,205,500,81.01,28,81.00,81.09,205,0
DSOC,200,300,30.92,300,30.80,30.97,200,0
DUDE,200,500,26.84,500,26.75,27.01,200,0
IBHF,200,589,25.45,100,25.40,25.45,200,0
PBTP,200,10700,26.55,200,26.53,26.53,200,0
IQM,199,1099,47.89,1200,47.80,47.88,199,0
EMTL,191,600,50.23,700,50.21,50.20,191,0
ESG,189,700,104.89,700,104.82,105.00,189,0
HYDB,185,2100,51.51,700,51.40,51.50,185,0
MFMS,181,800,38.90,800,38.60,38.79,181,0
FLHY,164,600,26.40,200,26.39,26.39,164,0
LYFE,161,1300,30.31,1300,30.28,30.49,161,0
EAOR,150,300,30.74,300,30.71,30.82,150,0
JPIB,141,700,51.22,600,51.21,51.22,141,0
QSPT,135,400,19.63,5000,19.54,19.62,135,0
IBHD,134,232,24.65,210,24.60,24.65,134,0
IDHD,126,700,26.29,1,26.20,26.40,126,0
FDEM,125,803,25.91,700,25.58,25.95,125,0
QDEC,121,5000,22.08,200,21.97,22.10,121,0
GSST,120,522,50.66,700,50.65,50.66,120,0
BJAN,119,3000,36.07,3500,35.94,36.02,119,0
FYLD,118,300,26.89,260,26.88,26.88,118,0
IVAL,114,200,26.76,300,26.70,26.83,114,0
LKOR,112,700,60.12,600,60.10,60.03,112,0
IBMM,111,1000,26.95,2100,26.89,26.90,111,0
PSMC,111,900,13.76,101,13.72,13.77,111,0
SMMD,111,100,63.93,600,63.78,63.96,111,0
BAUG,110,5000,31.25,500,31.13,31.25,110,0
VFMF,107,500,99.06,1400,98.91,99.44,107,0
FLDR,105,1500,50.89,300,50.86,50.87,105,0
LEAD,103,300,53.30,300,53.23,53.42,103,0
GCOW,102,700,29.78,1,29.71,29.81,102,0
PJAN,102,300,32.67,52,32.61,32.61,102,0
AMER,101,600,29.50,3600,29.40,29.50,101,0
ICOW,101,500,30.86,500,30.74,30.93,101,0
BJUN,100,900,32.73,200,32.60,32.76,100,0
FJUN,100,800,36.14,500,36.06,36.18,100,0
FMAR,100,600,31.77,300,31.70,31.75,100,0
IBMO,100,200,26.89,3900,26.85,26.87,100,0
LQDI,100,2400,30.16,600,30.09,29.98,100,0
GOAT,99,1000,38.38,1000,38.35,38.44,99,0
ISVL,96,1000,35.61,1000,35.53,35.69,96,0
TRTY,94,100,27.16,100,27.08,27.22,94,0
IGEB,91,900,53.81,700,53.78,53.73,91,0
PBEE,91,300,27.98,300,27.87,28.29,91,0
IAUF,80,100,53.90,100,53.75,53.76,80,0
DAUG,79,500,34.06,500,33.95,34.02,79,0
OEUR,77,600,27.30,600,27.19,27.33,77,0
OUSM,77,3000,34.55,501,34.50,34.71,77,0
IGLD,74,100,19.85,100,19.72,19.85,74,0
PAPR,68,500,28.56,400,28.49,28.63,68,0
IDME,62,400,24.36,500,24.33,24.48,62,0
IVLC,61,100,13.81,100,13.79,13.82,61,0
XSHQ,61,300,36.72,300,36.60,36.81,61,0
IVDG,58,100,12.87,100,12.85,12.96,58,0
UMAR,56,600,29.17,500,29.09,29.13,56,0
FAUG,51,900,36.40,500,36.33,36.40,51,0
PBSM,49,500,38.27,400,38.16,38.42,49,0
ESGG,46,400,140.82,100,139.59,140.76,46,0
FDEC,46,700,33.47,300,33.39,33.48,46,0
QMOM,44,300,48.60,500,48.49,48.86,44,0
WUGI,38,500,56.28,6,56.10,56.34,38,0
XSHD,37,700,22.04,700,22.01,22.01,37,0
IVSG,36,100,13.26,100,13.24,13.28,36,0
LVHI,36,500,25.49,500,25.41,25.50,36,0
XJR,36,1500,38.54,1200,38.47,38.69,36,0
GHYG,35,700,49.93,100,49.82,49.98,35,0
SULR,33,500,32.68,500,32.59,32.85,33,0
OMFS,32,568,39.68,500,39.59,39.95,32,0
TMAT,32,300,21.67,300,21.61,21.89,32,0
PSMM,31,800,15.40,400,15.32,15.37,31,0
BSEP,30,100,31.14,400,31.07,31.22,30,0
FOMO,30,2080,23.53,2200,23.46,23.90,30,0
NAPR,28,400,37.64,200,37.45,37.74,28,0
EFNL,26,1500,46.88,1200,46.74,47.05,26,0
NUMV,26,300,36.18,400,36.13,36.29,26,0
GMOM,25,300,29.29,300,29.21,29.27,25,0
TDV,24,400,59.44,400,59.36,59.79,24,0
YSEP,23,400,19.61,200,19.50,19.72,23,0
KAPR,17,400,27.20,200,27.08,27.37,17,0
WFHY,16,600,52.57,600,52.51,52.56,16,0
QTJL,15,400,25.84,200,25.76,25.90,15,0
RESE,15,600,35.31,300,35.17,35.54,15,0
NUDV,13,600,24.33,600,24.31,24.40,13,0
ALFA,12,1200,82.42,1200,82.26,82.95,12,0
HSRT,12,878,41.00,6774,40.90,41.00,12,0
IEME,12,400,36.39,400,36.33,36.33,12,0
DDLS,11,600,34.63,300,34.56,34.65,11,0
SMI,11,1100,49.78,1100,49.74,49.72,11,0
ALTS,10,500,38.60,500,38.41,38.47,10,0
PEX,10,300,36.35,300,36.21,36.36,10,0
GOVZ,9,2658,21.22,100,21.20,21.24,9,0
FFSG,8,1900,35.42,10,35.41,35.42,8,0
VIRS,8,500,31.83,500,31.77,32.39,8,0
WDNA,8,37,25.00,100,24.83,25.00,8,0
PBND,7,600,25.90,700,25.89,25.87,7,0
HYXU,6,600,55.24,600,55.14,55.15,6,0
NUDM,6,1200,31.29,349,31.17,31.43,6,0
TFIV,6,500,23.87,500,23.81,23.83,6,0
UJUN,6,500,28.67,400,28.61,28.80,6,0
VXZ,6,600,27.05,300,26.99,26.70,6,0
XDAT,6,998,27.06,1000,27.00,27.17,6,0
TFLT,5,500,23.47,9,23.43,23.43,5,0
EMDV,4,100,58.22,500,57.72,58.06,4,0
SECT,4,2700,40.50,2500,40.44,40.50,4,0
USMF,4,2000,38.73,200,38.69,39.00,4,0
VAMO,4,5000,24.12,100,24.06,24.28,4,0
DECZ,3,1000,28.26,1000,28.15,28.34,3,0
EUDV,3,100,51.87,100,51.71,51.97,3,0
JMST,3,11500,51.07,1200,51.05,51.05,3,0
OBND,3,2100,30.09,600,30.05,30.10,3,0
SFIG,3,600,51.36,600,51.35,51.32,3,0
WFIG,3,700,54.23,700,54.21,54.14,3,0
ZECP,3,1000,23.86,30,23.79,24.19,3,0
ACIO,2,3000,29.82,6000,29.74,29.86,2,0
ADME,2,3000,39.36,3000,39.29,39.54,2,0
BAPR,2,400,31.85,79,31.80,31.85,2,0
BLDG,2,100,31.46,15,31.13,31.32,2,0
BOSS,2,100,34.23,100,34.14,34.29,2,0
IBMN,2,500,27.94,2442,27.91,27.95,2,0
LSLT,2,700,30.60,700,30.57,30.77,2,0
MAMB,2,500,25.28,500,25.25,25.32,2,0
OSCV,2,700,32.64,700,32.59,32.66,2,0
PBDM,2,500,28.58,300,28.38,28.46,2,0
SLT,2,500,41.82,500,41.78,41.92,2,0
SPMV,2,400,36.99,100,36.93,37.27,2,0
TMDV,2,500,45.62,500,45.55,45.89,2,0
TTAC,2,1300,53.80,3,53.75,54.02,2,0
ADFI,1,400,9.70,500,9.67,9.66,1,0
APXH,1,500,9.33,500,9.29,9.61,1,0
BMAR,1,600,32.95,200,32.86,33.05,1,0
BMAY,1,100,31.23,3000,31.12,31.38,1,0
BOB,1,7100,25.27,500,25.17,25.53,1,0
DALT,1,400,10.19,400,10.16,10.35,1,0
DFHY,1,4000,24.88,1000,24.81,24.88,1,0
DFNV,1,4000,28.69,2000,28.61,29.12,1,0
ESCR,1,100,22.12,1500,22.07,22.00,1,0
FEDX,1,2200,27.97,400,27.92,28.38,1,0
FLIA,1,800,25.19,800,25.17,25.17,1,0
FPFD,1,1100,25.32,50,25.31,25.32,1,0
IMFL,1,72,25.89,100,25.85,26.07,1,0
MRGR,1,300,41.00,100,40.95,40.88,1,0
PAUG,1,3700,29.17,50,29.10,29.31,1,0
PJUN,1,500,31.14,200,31.03,31.13,1,0
PWS,1,400,31.77,400,31.72,31.94,1,0
RTAI,1,8300,27.95,1400,27.88,28.12,1,0
SEPZ,1,5000,29.95,2000,29.84,30.13,1,0
STLG,1,700,35.63,700,35.58,35.96,1,0
STOT,1,200,49.54,900,49.52,49.53,1,0
TILT,1,500,168.20,500,168.11,169.40,1,0
TTAI,1,1500,35.18,1500,35.10,35.33,1,0
VWID,1,1000,28.01,1000,27.94,28.20,1,0
ACSI,0,4500,48.86,4500,48.80,0.00,0,0
AGT,0,700,28.36,600,28.32,0.00,0,0
APRZ,0,3000,26.28,3000,26.16,0.00,0,0
ARCM,0,1000,100.08,1000,99.98,0.00,0,0
ATMP,0,300,15.76,300,15.72,0.00,0,0
AUGZ,0,5000,31.17,5000,31.07,0.00,0,0
AVDG,0,6800,29.22,3000,29.16,0.00,0,0
BDEC,0,3000,33.47,500,33.33,0.00,0,0
BFEB,0,5000,30.80,3200,30.66,0.00,0,0
BGLD,0,100,18.78,100,18.70,0.00,0,0
BNOV,0,2532,32.15,1800,32.06,0.00,0,0
CFCV,0,2200,34.57,3700,34.47,0.00,0,0
DAPR,0,100,30.59,300,30.52,0.00,0,0
DBJA,0,100,27.71,100,27.58,0.00,0,0
DDEC,0,100,32.06,300,31.98,0.00,0,0
DEFN,0,1500,24.04,1500,23.94,0.00,0,0
DJUL,0,6000,32.61,5200,32.46,0.00,0,0
DJUN,0,500,33.56,300,33.46,0.00,0,0
DMAR,0,600,31.06,300,30.98,0.00,0,0
DMAY,0,5400,33.79,5200,33.60,0.00,0,0
DNOV,0,400,34.98,200,34.81,0.00,0,0
DOCT,0,200,32.47,200,32.39,0.00,0,0
DSJA,0,100,28.92,100,28.77,0.00,0,0
EAOK,0,300,27.58,300,27.55,0.00,0,0
EAOM,0,300,28.64,300,28.61,0.00,0,0
EMSH,0,300,72.91,300,72.63,0.00,0,0
ESEB,0,1500,21.31,100,21.23,0.00,0,0
ESHY,0,1500,21.15,1500,21.05,0.00,0,0
EUCG,0,4000,26.29,200,26.23,0.00,0,0
EURZ,0,1000,26.32,1000,26.29,0.00,0,0
FAPR,0,900,30.87,300,30.79,0.00,0,0
FEBZ,0,2000,27.74,5000,27.63,0.00,0,0
FFEB,0,5000,36.63,4200,36.49,0.00,0,0
FFHG,0,1500,35.16,1800,35.05,0.00,0,0
FFTG,0,340,28.87,300,28.78,0.00,0,0
FFTI,0,500,24.13,800,24.07,0.00,0,0
FJUL,0,4500,34.56,6000,34.46,0.00,0,0
FLQS,0,600,37.65,100,37.60,0.00,0,0
FMAY,0,3100,36.29,1000,36.19,0.00,0,0
FOCT,0,400,34.43,200,34.29,0.00,0,0
FUNL,0,500,33.53,500,33.48,0.00,0,0
FUT,0,100,41.01,600,40.92,0.00,0,0
GSEE,0,1000,51.84,1000,51.74,0.00,0,0
GSID,0,1000,55.13,1000,55.02,0.00,0,0
GSUS,0,2200,59.67,2200,59.60,0.00,0,0
HCRB,0,700,41.09,700,41.07,0.00,0,0
HEET,0,2300,23.92,300,23.87,0.00,0,0
HSUN,0,600,39.76,600,39.73,0.00,0,0
IBHA,0,100,24.24,304,24.10,0.00,0,0
IBHE,0,221,24.92,363,24.86,0.00,0,0
IBMP,0,600,27.01,705,26.96,0.00,0,0
IBMQ,0,800,27.23,700,27.18,0.00,0,0
IMLP,0,400,12.59,400,12.55,0.00,0,0
JANZ,0,4000,28.04,1000,27.92,0.00,0,0
JULZ,0,3500,32.60,3500,32.44,0.00,0,0
JUNZ,0,7000,25.44,1,25.42,0.00,0,0
LIV,0,1000,25.88,3200,25.78,0.00,0,0
MAAX,0,3000,24.81,3,24.77,0.00,0,0
MARZ,0,7000,27.02,7000,26.92,0.00,0,0
MAYZ,0,7000,25.51,5000,25.42,0.00,0,0
MBBB,0,700,25.12,700,25.10,0.00,0,0
MBCC,0,500,28.33,500,28.29,0.00,0,0
MBND,0,400,29.92,400,29.87,0.00,0,0
MDEV,0,1000,25.58,1000,25.51,0.00,0,0
MIG,0,700,24.96,700,24.95,0.00,0,0
MINN,0,1700,25.03,200,24.96,0.00,0,0
MPRO,0,500,26.42,500,26.39,0.00,0,0
MRSK,0,5000,31.05,5000,30.96,0.00,0,0
MSVX,0,1500,25.23,400,25.14,0.00,0,0
NULC,0,500,40.26,500,40.22,0.00,0,0
PDEC,0,3000,30.78,9433,30.70,0.00,0,0
PFEB,0,438,28.60,2000,28.48,0.00,0,0
PLRG,0,300,25.93,1500,25.88,0.00,0,0
PLTL,0,300,24.98,300,24.92,0.00,0,0
PMAY,0,5100,29.55,5000,29.39,0.00,0,0
PNOV,0,300,30.53,300,30.44,0.00,0,0
PSCJ,0,300,20.52,400,20.46,0.00,0,0
PSCQ,0,300,20.45,300,20.39,0.00,0,0
PSCW,0,3000,21.40,3000,21.28,0.00,0,0
PSCX,0,3000,22.03,3000,21.93,0.00,0,0
PSFD,0,3000,23.28,3000,23.13,0.00,0,0
PSFF,0,3000,21.95,3000,21.83,0.00,0,0
PSFJ,0,300,20.55,300,20.50,0.00,0,0
PSFM,0,3000,21.99,3000,21.87,0.00,0,0
PSFO,0,300,20.44,300,20.39,0.00,0,0
PSMD,0,3000,22.42,3000,22.30,0.00,0,0
PSMJ,0,300,20.53,300,20.47,0.00,0,0
PSMO,0,300,20.46,300,20.40,0.00,0,0
PSMR,0,3000,21.57,3000,21.45,0.00,0,0
PXUS,0,100,24.43,300,24.27,0.00,0,0
QCON,0,600,46.94,600,46.91,0.00,0,0
QJUN,0,5000,20.33,5200,20.21,0.00,0,0
QMAR,0,700,21.78,300,21.67,0.00,0,0
QPFF,0,100,41.13,100,40.98,0.00,0,0
QTAP,0,400,28.27,1000,28.25,0.00,0,0
RDFI,0,8200,29.54,3400,29.46,0.00,0,0
REC,0,500,24.88,500,24.85,0.00,0,0
RODE,0,2000,28.36,501,28.25,0.00,0,0
RODI,0,100,121.01,100,119.52,0.00,0,0
STLV,0,900,28.41,900,28.36,0.00,0,0
TBJL,0,300,24.01,400,23.92,0.00,0,0
TCTL,0,2500,32.58,2500,32.53,0.00,0,0
TEGS,0,15600,27.65,100,27.56,0.00,0,0
TFJL,0,300,23.44,300,23.35,0.00,0,0
THY,0,3000,24.96,100,24.87,0.00,0,0
UAPR,0,400,25.76,300,25.66,0.00,0,0
UAUG,0,4700,28.44,4000,28.34,0.00,0,0
UDEC,0,3000,29.67,3200,29.53,0.00,0,0
UFEB,0,3900,27.56,3900,27.45,0.00,0,0
UJAN,0,3000,31.13,3200,31.01,0.00,0,0
UJUL,0,300,26.94,300,26.86,0.00,0,0
UMAY,0,5400,28.05,1000,27.90,0.00,0,0
UNOV,0,948,29.30,500,29.21,0.00,0,0
USEQ,0,3450,35.50,300,35.43,0.00,0,0
VMOT,0,700,26.48,700,26.40,0.00,0,0
WIL,0,100,94.99,49,93.28,0.00,0,0
WLDR,0,300,26.90,300,26.75,0.00,0,0
XBAP,0,3500,26.52,10,26.45,0.00,0,0
XBJL,0,3500,25.73,3500,25.59,0.00,0,0
XDAP,0,3500,27.27,3600,27.13,0.00,0,0
XDJL,0,3500,25.80,3500,25.68,0.00,0,0
XJUN,0,4000,29.63,3500,29.45,0.00,0,0
XTAP,0,300,27.27,300,27.12,0.00,0,0
XTJL,0,200,25.85,200,25.70,0.00,0,0
YDEC,0,400,21.32,200,21.21,0.00,0,0
YJUN,0,400,19.90,200,19.79,0.00,0,0
YMAR,0,400,20.55,200,20.44,0.00,0,0
YPS,0,7000,22.95,7000,22.88,0.00,0,0